{
    "layers": [
        {
            "z": 0,
            "tiles": [
                [11,12,12,12,12,12,12,12,12,13],
                [4,5,5,5,5,5,5,5,5,6],
                [4,5,5,5,5,5,5,5,5,6],
                [4,5,5,5,5,5,5,5,5,6],
                [4,5,5,5,5,5,5,5,5,6],
                [4,5,5,5,5,5,5,5,5,6],
                [4,5,5,5,5,5,5,5,5,6],
                [4,5,5,5,5,5,5,5,5,6],
                [4,5,5,5,5,5,5,5,5,6],
                [7,8,8,8,8,8,8,8,8,9]
            ]
        },
        {
            "z": 1,
            "tiles": [
                [0,0,0,0,0,0,0,0,0,0],
                [0,0,0,0,0,0,0,0,0,0],
                [0,0,0,0,0,0,0,0,0,0],
                [0,0,0,0,0,0,0,0,0,0],
                [0,0,0,0,200,0,0,0,0,0],
                [0,0,0,0,0,0,0,0,0,0],
                [0,0,0,0,0,0,0,0,0,0],
                [0,0,0,0,0,0,0,0,0,0],
                [0,0,0,0,0,0,0,0,0,0],
                [0,0,0,0,0,0,0,0,0,0]
            ]
        }
    ]
}